NO ./textures/map/north_wall.xpm
SO ./textures/map/south_wall.xpm
WE ./textures/map/west_wall.xpm
EA ./textures/map/east_wall.xpm 
C 200,167,45
F 255,0,0


111111111111111
100000000000001
100000000000001
100000000000001
100000000000001
100000000000001
100000000000001
1000000S0000001
100000000000001
100000000000001
100000000000001
100000000000001
1000000M0000001
100000000000001
100000000000001
100000000000001
100000000000001
100000000000001
1111111D1111111
   100000001   
   111000111
     11111