NO north_file    
SO south_file
WE west_file    
EA east_file
C  ceiling_file
F  floor_file


111111111111111
100000100000001
100000010000001
100000001000001
100000000100001
100000000000001
100000000000001
100000000000001
100000000000001
100000000000001
100000000000001
100000000000001
100000000000001
100000000000001
100000000000001
100000000000001
100000000000001
100000000000001
100000000000001
1000000N0000001
100000000000001
100000000000001
111100000001111
   100000001   
   111000111
     11111