NO ./textures/map/north_wall.xpm
SO ./textures/map/south_wall.xpm
WE ./textures/map/west_wall.xpm
EA ./textures/map/east_wall.xpm 
C ./textures/map/ceiling.xpm                      
F ./textures/map/floor3.xpm   


111111111111111
100000000000001
100000000000001
100000000000001
1000000M0000001
100000000000001
100000000000001
100000000000001
100000000000001
100000000000001
100000000000001
1111111D1101111
100000000000001
100M00000000001
100000000000001
100000000000001
100000000000001
100000000000001
100000000000001
1000000N0000001
100000000000001
100000000000001
111100000001111
   100000001   
   111000111
     11111