NO ./textures/map/north_wall.xpm
SO ./textures/map/south_wall.xpm
WE ./textures/map/west_wall.xpm
EA ./textures/map/east_wall.xpm 
C ./textures/map/ceiling.xpm                      
F ./textures/map/floor3.xpm   


111111111111111
100000000000001
100000MM0000001
100000000000001
100000000000001
100000000MM0001
100000000000001
1111011D1111111
100M00000010001
100000000010001
1000000000D0001
1001D1000010001
100000000000001
1000N0000000001
100000000000001
100000000000001
100000000000001
100000000000001
111100000001111
   100000001   
   111000111
     11111