NO ./textures/map/north_wall.xpm
SO ./textures/map/south_wall.xpm
WE ./textures/map/west_wall.xpm
EA ./textures/map/east_wall.xpm 
C ./textures/map/ceiling.xpm 
F ./textures/map/floor3.xpm   


1111111111111111111111111111111111111111111111111111111
1MMMMMMMMMMMMMMMMMMMMMMMMMMMMMMMMMMMMMMMMMMMMMMMMMMMMM1
1MMMMMMMMMMMMMMMMMMMMMMMMMMMMMMMMMMMMMMMMMMMMMMMMMMMMM1
1MMMMMMMMMMMMMMMMMMMMMMMMMMMMMMMMMMMMMMMMMMMMMMMMMMMMM1
1MMMMMMMMMMMMMMMMMMMMMMMMMMMMMMMMMMMMMMMMMMMMMMMMMMMMM1
1MMMMMMMMMMMMMMMMMMMMMMMMMMMMMMMMMMMMMMMMMMMMMMMMMMMMM1
1MMMMMMMMMMMMMMMMMMMMMMMMMMMMMMMMMMMMMMMMMMMMMMMMMMMMM1
1MMMMMMMMMMMMMMMMMMMMMMM1D1D1MMMMMMMMMMMMMMMMMMMMMMMMM1
1MMMMMMMMMMMMMMMMMMMMMMMD000DMMMMMMMMMMMMMMMMMMMMMMMMM1
1MMMMMMMMMMMMMMMMMMMMMMM10001MMMMMMMMMMMMMMMMMMMMMMMMM1
1MMMMMMMMMMMMMMMMMMMMMMMD0N0DMMMMMMMMMMMMMMMMMMMMMMMMM1
1MMMMMMMMMMMMMMMMMMMMMMM1D1D1MMMMMMMMMMMMMMMMMMMMMMMMM1
1MMMMMMMMMMMMMMMMMMMMMMMMMMMMMMMMMMMMMMMMMMMMMMMMMMMMM1
1MMMMMMMMMMMMMMMMMMMMMMMMMMMMMMMMMMMMMMMMMMMMMMMMMMMMM1
1MMMMMMMMMMMMMMMMMMMMMMMMMMMMMMMMMMMMMMMMMMMMMMMMMMMMM1
1MMMMMMMMMMMMMMMMMMMMMMMMMMMMMMMMMMMMMMMMMMMMMMMMMMMMM1
1MMMMMMMMMMMMMMMMMMMMMMMMMMMMMMMMMMMMMMMMMMMMMMMMMMMMM1
1MMMMMMMMMMMMMMMMMMMMMMMMMMMMMMMMMMMMMMMMMMMMMMMMMMMMM1
1MMMMMMMMMMMMMMMMMMMMMMMMMMMMMMMMMMMMMMMMMMMMMMMMMMMMM1
1111111111111111111111111111111111111111111111111111111