NO ./textures/map/north_wall.xpm
SO ./textures/map/south_wall.xpm
WE ./textures/map/west_wall.xpm
EA ./textures/map/east_wall.xpm 
C ./textures/map/ceiling.xpm 
F ./textures/map/floor3.xpm   

1111
10M1
10N1
1111