NO ./textures/minimap/mm_vacum.xpm
SO ./textures/map/south_wall.xpm
WE ./textures/map/west_wall.xpm
EA ./textures/map/east_wall.xpm 
C ./textures/map/ceiling.xpm 
F ./textures/map/floor3.xpm   

111111111111111
100000000000001
100000000000001
10000000M000001
100000000000001
100000000000001
100000N00000001
111111D10000001
100001010000001
111111011111111
100001001000001
100001001000001
100000000000001
111111111111111