NO ./textures/map/north_wall.xpm
SO ./textures/map/south_wall.xpm
WE ./textures/map/west_wall.xpm
EA ./textures/map/east_wall.xpm 
C ./textures/map/ceiling.xpm                      
F ./textures/map/floor3.xpm   


1111111111111111111111111
1000000000000000000000001
1000000000000000000000001
1000111111111111111000001
1000100000000000001000001
1000100000000000001000001
10001000000S0000001000001
1000100000000000001000001
1000100000000000001000001
1000100011111100001000001
1000100010000100001000001
1000100000M00000001000001
1000111111111111111000001
1000000000000000000000001
1000000000000000000000001
1111111111111111111111111