NO ./textures/map/north_wall.xpm
SO ./textures/map/south_wall.xpm
WE ./textures/map/west_wall.xpm
EA ./textures/map/east_wall.xpm 
C ./textures/map/ceiling.xpm                      
F ./textures/map/floor3.xpm   



111111111111111
100000000000001
100000000000001
100000000000001
1000000000W0001
100000000000001
100011110000001
100000000000001
1M0000000000001
111111111111111