NO ./textures/map/north_wall.xpm
SO ./textures/map/south_wall.xpm
WE ./textures/map/west_wall.xpm
EA ./textures/map/east_wall.xpm 
C ./textures/map/ceiling.xpm 
F ./textures/map/floor3.xpm   

111111111111111
100000000000001
100000000000001
1000000M0000001
100000000000001
100011111100001
100010000100001
1000100N0111101
100010000000001
111111111111111