NO ./textures/map/north_wall.xpm
SO ./textures/map/south_wall.xpm
WE ./textures/map/west_wall.xpm
EA ./textures/map/east_wall.xpm 
C ./textures/map/ceiling.xpm                      
F ./textures/map/floor3.xpm   



111111111111111
1MMMMMMMMMMMMM1
1MMMMMMMMMMMMM1
1MMMMMMMMMMMMM1
1MMMMMMMMMMMMM1
1MMMMMMMMMMMMM1
1MMMMMMMMMMMMM1
1MMMMMMMMMMMMM1
1M000N000000001
111111111111111