


       NO                                     north_file    

   SO south_file        

                WE         west_file    

 EA                                                                                                              east_file 



                            C                                             ceiling_file                     

             F      floor_file         




     111111111111111111        1111111111111111111111111111111111111111111111111
     100000000000000001        1000000000000000000000000000000000000000000000001
     100000000000000001111111111000000000000000000000000000000000000000000000001
     100000000000000000000000000000000000000000000000000000000000000000000000001
     100000000000000001111111111000011111111111111111100000011111111111111100001
     100000000000000001        1000010000000000000000000000000000000000000100001
     100000000000000001        1000010000000000000000000000000000000000000100001
     100000000000000001        1000000000000000000000000000000000000000000000001
     100000000000000001        1000000000000000000000000000000000000000000000001
     100000000000000001        1000000000000000000000000000000000000000000000001
     100000000000000001        1000010000000000000000000000000000000000000100001
     100000000000000001        1000010000000000000000000000000000000000000100001
     100000000000000001111111111000011111111111111111100000011111111111111100001
     100000000000000000000000000000000000000000000000000000000000000000000000001
     100000000000000001111111111000000000000000000000000000000000000000000000001
     100000000000000001        1000000000000000000000000000000000000000000000001
     111111111111111111        1111111111111111111111111111111111111111111111001
                                                                            1001
                                                                            1001
                                                                            1001
                                                                            1001
                                                                            1001
11111111   111111111111111111                   11111111111111111           1001
10000001   100N00000000000001                   10000000000000001           1001
10000001   100000000010000001                   10001000000010001           1001
100000011111000000001 1000001111111111111111111110001000000010001           1001
10000000000000000000010000000000000000000000000000001000000010001           1001
10000001111100000000000000001111111111111111111110000000000000001           1001
10000001   100000000000000001                   10001000000010001           1001
10000001   111111111110111111                   10001000000010001           1001
10000001             101                        10001000000010001           1001
10000001   111111111110111111                   10000000000000001           1001
10000001   100000000000000001                   11111111001111111           1001
10000001   100000000000000001                          1001                 1001
10000001   100000000000000001                          1001                 1001
10000001   111111100111111111                          1001                 1001
10000001         1001                                  1001                 1001
10000001         100111111111111111111111111111111111111001                 1001
11111111         100000000000000000000000000000000000000001                 1001
                 111111111111111111111111111111111111111001                 1001
                                                       1001                 1001
                                                       1001111111111111111111001
                                                       1000000000000000000000001
                                                       1000000000000000000000001
                                                       1111111111111111111111111